4 A SYNDROME	4A SYNDROME
4A ' SYNDROME	4A SYNDROME
4A '' SYNDROME	4A SYNDROME
ALLGROVE SYNDROME GENE	AAAS GENE
TRIPLE A GENE	AAAS GENE
AAAS-GENE	AAAS GENE
TRIPLE A SYNDROME GENE	AAAS GENE
ABNORMAL COAGULATION SYSTEM	ABNORMAL COAGULATION
ABNORMAL BODY FAT DISTRIBUTION	ABNORMAL FAT PADS
ABNORMAL DISTRIBUTION OF ADIPOSE TISSUE	ABNORMAL FAT PADS
ABNORMAL FAT DISTRIBUTION	ABNORMAL FAT PADS
ABNORMAL SUBCUTANEOUS FAT DISTRIBUTION	ABNORMAL FAT PADS
ABNORMAL SUBCUTANEOUS FAT PADS	ABNORMAL FAT PADS
DEFECTIVE TEAR FORMATION	ABNORMAL TEAR PRODUCTION
DISRUPTED TEAR SECRETION	ABNORMAL TEAR PRODUCTION
DYSFUNCTIONAL LACRIMATION	ABNORMAL TEAR PRODUCTION
ISOLATED DYSFUNCTION OF LACRIMATION	ABNORMAL TEAR PRODUCTION
ABSENCE OR DEFICIENCY OF TEAR VOLUME	ABNORMAL TEAR PRODUCTION
ACHILASIA	ACHALASIA
ACHALASIA OF THE CARDIA	ACHALASIA CARDIA
ACHALASIA OF THE OESOPHAGUS	ACHALASIA OF THE ESOPHAGUS
ACTH RESISTANCE SYNDROME	ACTH INSENSITIVITY (SYNDROME)
ACTH RESISTANCE SYNDROMES	ACTH INSENSITIVITY (SYNDROME)
ACTH-RESISTANT SYNDROMES	ACTH INSENSITIVITY (SYNDROME)
ADRENOCORTICOTROPHIC HORMONE ( ACTH ) INSENSITIVITY	ACTH INSENSITIVITY (SYNDROME)
ADRENOCORTICOTROPHIN RESISTANCE SYNDROME	ACTH INSENSITIVITY (SYNDROME)
ADRENOCORTICOTROPHIN RESISTANCE SYNDROME	ACTH INSENSITIVITY (SYNDROME)
ADRENOCORTICOTROPHIN RESISTANCE SYNDROMES	ACTH INSENSITIVITY (SYNDROME)
ADRENOCORTICOTROPIC HORMONE RESISTANCE	ACTH INSENSITIVITY (SYNDROME)
ADRENOCORTICOTROPIC HORMONE RESISTANT ADRENAL INSUFFICIENCY	ACTH INSENSITIVITY (SYNDROME)
ADRENOCORTICOTROPIC HORMONE-RESISTANT ADRENAL INSUFFICIENCY	ACTH INSENSITIVITY (SYNDROME)
ADRENOCORTICOTROPIN ( ACTH ) RESISTANCE SYNDROMES	ACTH INSENSITIVITY (SYNDROME)
ADRENOCORTICOTROPIN ( ACTH ) -RESISTANT ADRENAL INSUFFICIENCY	ACTH INSENSITIVITY (SYNDROME)
ADRENOCORTICOTROPIN HORMONE-RESISTANT ADRENAL INSUFFICIENCY	ACTH INSENSITIVITY (SYNDROME)
ACTH INSENSITIVITY	ACTH INSENSITIVITY (SYNDROME)
ACTH INSENSITIVITY SYNDROMES	ACTH INSENSITIVITY (SYNDROME)
ACTH RESISTANCE	ACTH INSENSITIVITY (SYNDROME)
ACTHR	ACTH-R
ADRENOCORTICOTROPIN RECEPTOR	ACTH-R
ADRENOCORTICOTROPHIC HORMONE ( ACTH ) RESISTANT ADRENAL INSUFFICIENCY	ACTH-RESISTANT ADRENAL INSUFFICIENCY
ADRENOCORTICOTROPIC HORMONE ( ACTH ) -RESISTANT ADRENAL INSUFFICIENCY	ACTH-RESISTANT ADRENAL INSUFFICIENCY
ADRENOCORTICOTROPIC HORMONE ( ACTH ) RESISTANT ADRENAL INSUFFICIENCY	ACTH-RESISTANT ADRENAL INSUFFICIENCY
ACUTE FLUID-LOSS	ACUTE DEHYDRATION
ADDISON CRISIS	ADDISON'S DISEASE
ADDISON DISEASE	ADDISON'S DISEASE
ADDISON INSUFFICIENCY	ADDISON'S DISEASE
ADDISON 'S	ADDISON'S DISEASE
ADDISON S DISEASE	ADDISON'S DISEASE
ADDISON 'S DISEASE	ADDISON'S DISEASE
ADDISONIANISM	ADDISON'S DISEASE
ADDISONISM	ADDISON'S DISEASE
ADDISON'S	ADDISON'S DISEASE
ADDISONS DISEASE	ADDISON'S DISEASE
ADRENAL CRISIS	ADRENAL DYSFUNCTION
ADRENAL GLAND INSUFFICIENCY	ADRENOCORTICAL INSUFFICIENCY
ADRENAL INSUFFICIENCY	ADRENOCORTICAL INSUFFICIENCY
ADRENOCORTICAL INSUFFICIENCY	ADRENOCORTICAL INSUFFICIENCY
ADRENOCORTICOTROPIN-RESISTANT ADRENAL INSUFFICIENCY	ADRENOCORTICAL INSUFFICIENCY
ABSENCE OF TEARS	ALACRIMA
ABSENT TEAR PRODUCTION	ALACRIMA
ABSENT TEAR SECRETION	ALACRIMA
ACLARIMA	ALACRIMA
ALACRIMIA	ALACRIMA
LACK OF LACRIMATION	ALACRIMA
NO TEAR PRODUCTION	ALACRIMA
UNABLE TO PRODUCE TEARS	ALACRIMA
ACHALASIA-ADDISONIANISM-ALACRIMA-SYNDROME GENE	ALADIN
ALCOHOL ABUSE	ALCOHOLISM
HALG1	ALG1
HALG11	ALG11
HALG2	ALG2
ALACRIMA ACHALASIA ADRENAL INSUFFICIENCY SYNDROME	ALLGROVE SYNDROME
3A SYNDROME	ALLGROVE SYNDROME
AAAS SYNDROME	ALLGROVE SYNDROME
ACHALASIA-ADDISONIANISM-ALACRIMA SYNDROME	ALLGROVE SYNDROME
ACHALASIA-ADDISONIANISM-ALACRIMA-SYNDROME	ALLGROVE SYNDROME
ACHALASIA-ALACRIMA-ACTH INSENSITIVITY SYNDROME	ALLGROVE SYNDROME
ACHALASIA-ALACRIMA-ADRENAL GLAND INSUFFICIENCY	ALLGROVE SYNDROME
ALLGROVE	ALLGROVE SYNDROME
ALLGROVE ( TRIPLE-A ) SYNDROME	ALLGROVE SYNDROME
ALLGROVE 'S SYNDROME	ALLGROVE SYNDROME
TRIPLE A	ALLGROVE SYNDROME
TRIPLE A '' SYNDROME	ALLGROVE SYNDROME
TRIPLE A ( 3A ) SYNDROME	ALLGROVE SYNDROME
TRIPLE A ( ALLGROVE ) SYNDROME	ALLGROVE SYNDROME
TRIPLE A DISEASE	ALLGROVE SYNDROME
TRIPLE A SYNDROME	ALLGROVE SYNDROME
TRIPLE ASYNDROME	ALLGROVE SYNDROME
TRIPLE ASYNDROME	ALLGROVE SYNDROME
TRIPLE-A	ALLGROVE SYNDROME
TRIPLE-A SYNDROME	ALLGROVE SYNDROME
TRIPLE-A-SYNDROME	ALLGROVE SYNDROME
AAAS	ALLGROVE SYNDROME GENE
A1A	ALPHA 1-ANTITRYPSIN
A1AT	ALPHA 1-ANTITRYPSIN
AAT	ALPHA 1-ANTITRYPSIN
ALPHA ( 1 ) -ANTITRYPSIN	ALPHA 1-ANTITRYPSIN
ALPHA ( 1 ) -AT	ALPHA 1-ANTITRYPSIN
ALPHA1 -ANTITRYPSIN	ALPHA 1-ANTITRYPSIN
ALPHA1-ANTITRYPSIN	ALPHA 1-ANTITRYPSIN
ALPHA-1-ANTITRYPSIN	ALPHA 1-ANTITRYPSIN
ALPHA1AT	ALPHA 1-ANTITRYPSIN
ALPHA1-AT	ALPHA 1-ANTITRYPSIN
SERPINA1	ALPHA 1-ANTITRYPSIN
AACT	ALPHA1-ANTICHYMOTRYPSIN
ALPHA ( 1 ) -ANTICHYMOTRYPSIN	ALPHA1-ANTICHYMOTRYPSIN
ALPHA1-ACT	ALPHA1-ANTICHYMOTRYPSIN
SERPINA3	ALPHA1-ANTICHYMOTRYPSIN
AD	ALZHEIMER DISEASE
ALZHEIMER 'S	ALZHEIMER DISEASE
ALZHEIMER 'S DISEASE	ALZHEIMER DISEASE
ALZHEIMER'S	ALZHEIMER DISEASE
ALZHEIMERS DISEASE	ALZHEIMER DISEASE
ALZHEIMER'S DISEASE	ALZHEIMER DISEASE
AMINO ACIDOPATHIES	AMINOACIDOPATHIES
AMYLOID PRECURSOR PROTEIN	AMYLOID BETA PRECURSOR PROTEIN
APP	AMYLOID BETA PRECURSOR PROTEIN
ANAEMIA	ANEMIA
ANTICONVULSANTS	ANTICONVULSANT AGENTS
ANTITHROMBIN III	ANTITHROMBIN-III
APOCIII	APOLIPOPROTEIN C-III
APOC-III	APOLIPOPROTEIN C-III
ARRHYTHMIAS	ARRHYTHMIA
ASIALOTRANSFERRIN	ASIALO-TRANSFERRIN
AUTONOMIC / NEUROLOGICAL ABNORMALITIES	AUTONOMIC ABNORMALITIES
AUTONOMIC AND OTHER NEUROLOGICAL ABNORMALITIES	AUTONOMIC ABNORMALITIES
AUTONOMIC DISTURBANCES	AUTONOMIC ABNORMALITIES
AUTONOMIC DYSFUNCTION	AUTONOMIC ABNORMALITIES
AUTONOMIC INSTABILITY	AUTONOMIC ABNORMALITIES
AUTONOMIC NERVOUS DYSFUNCTION	AUTONOMIC ABNORMALITIES
AUTOSOMAL RECESSIVE CUTIS LAXA TYPE II	AUTOSOMAL RECESSIVE CUTIS LAXA TYPE-2
AUTOSOMAL RECESSIVE CONDITION	AUTOSOMAL RECESSIVE DISORDER
AUTOSOMAL RECESSIVE DISEASE	AUTOSOMAL RECESSIVE DISORDER
AUTOSOMAL RECESSIVE DISORDERS	AUTOSOMAL RECESSIVE DISORDER
AUTOSOMAL RECESSIVE INHERENT DISORDER	AUTOSOMAL RECESSIVE DISORDER
AUTOSOMAL RECESSIVE INHERITED DISEASES	AUTOSOMAL RECESSIVE DISORDER
AUTOSOMAL RECESSIVE SYNDROME	AUTOSOMAL RECESSIVE DISORDER
AUTOSOMAL-RECESSIVE DISEASE	AUTOSOMAL RECESSIVE DISORDER
AUTOSOMAL-RECESSIVE DISEASES	AUTOSOMAL RECESSIVE DISORDER
AUTOSOMAL-RECESSIVE DISORDER	AUTOSOMAL RECESSIVE DISORDER
AUTOSOMAL-RECESSIVE DISORDER	AUTOSOMAL RECESSIVE DISORDER
AUTOSOMAL RECESSIVE GENETIC DEFECTS	AUTOSOMAL RECESSIVE DISORDER
AUTOSOMAL RECESSIVE GENETIC DISORDER	AUTOSOMAL RECESSIVE DISORDER
AUTOSOMAL RECESSIVE INHERITED DISORDER	AUTOSOMAL RECESSIVE DISORDER
BALLOON DILATATION	BALLOON DILATATIONS
CARDIAC TRANSPLANTATION	CARDIAC TRANSPLANT
HEART TRANSPLANTATION	CARDIAC TRANSPLANT
CARDIOMYOPATHIES	CARDIOMYOPATHY
CARBOHYDRATE DEFICIENT GLYCOPROTEIN SYNDROME TYPE 1	CDG TYPE I
CARBOHYDRATE DEFICIENT GLYCOPROTEIN SYNDROME TYPE I	CDG TYPE I
CARBOHYDRATE DEFICIENT GLYCOPROTEIN SYNDROMES TYPE I	CDG TYPE I
CARBOHYDRATE-DEFICIENT GLYCOPROTEIN ( CDG ) SYNDROME TYPE I	CDG TYPE I
"CARBOHYDRATE-DEFICIENT GLYCOPROTEIN SYNDROME , TYPE 1"	CDG TYPE I
"CARBOHYDRATE-DEFICIENT GLYCOPROTEIN SYNDROME , TYPE 1"	CDG TYPE I
"CARBOHYDRATE-DEFICIENT GLYCOPROTEIN SYNDROME , TYPE I"	CDG TYPE I
"CARBOHYDRATE-DEFICIENT GLYCOPROTEIN SYNDROME , TYPE I"	CDG TYPE I
CARBOHYDRATE-DEFICIENT GLYCOPROTEIN SYNDROME I	CDG TYPE I
CARBOHYDRATE-DEFICIENT GLYCOPROTEIN SYNDROME TYPE 1	CDG TYPE I
CARBOHYDRATE-DEFICIENT GLYCOPROTEIN SYNDROME TYPE I	CDG TYPE I
CARBOHYDRATE-DEFICIENT GLYCOPROTEIN SYNDROMES TYPE I	CDG TYPE I
CARBOHYDRATE-DEFICIENT-GLYCOPROTEIN SYNDROME TYPE 1	CDG TYPE I
CDG 1	CDG TYPE I
CDG GROUP I	CDG TYPE I
CDG I	CDG TYPE I
CDG SYNDROME TYPE I	CDG TYPE I
CDG TYPE 1	CDG TYPE I
CDG TYPE-I	CDG TYPE I
CDG TYPES I	CDG TYPE I
CDG1	CDG TYPE I
CDGI	CDG TYPE I
CDG-I	CDG TYPE I
CDGS TYPE 1	CDG TYPE I
CDGS TYPE I	CDG TYPE I
CDGS TYPE-I	CDG TYPE I
CDGS1	CDG TYPE I
CDGS-1	CDG TYPE I
CDGS-I	CDG TYPE I
CONGENITAL DISORDER OF GLYCOSYLATION TYPE I	CDG TYPE I
CONGENITAL DISORDERS OF GLYCOSYLATION TYPE I	CDG TYPE I
TYPE 1 CDG	CDG TYPE I
TYPE 1 CDGS	CDG TYPE I
TYPE 1 CONGENITAL DISORDERS OF GLYCOSYLATION	CDG TYPE I
TYPE I CARBOHYDRATE DEFICIENT GLYCOPROTEIN ( CDG ) SYNDROME	CDG TYPE I
TYPE I CARBOHYDRATE DEFICIENT GLYCOPROTEIN SYNDROME	CDG TYPE I
TYPE I CARBOHYDRATE-DEFICIENT GLYCOPROTEIN ( CDG ) SYNDROME	CDG TYPE I
TYPE I CARBOHYDRATE-DEFICIENT GLYCOPROTEIN SYNDROME	CDG TYPE I
TYPE I CDG	CDG TYPE I
TYPE I CDG SYNDROME	CDG TYPE I
TYPE I CDGS	CDG TYPE I
TYPE I CONGENITAL DISORDER OF GLYCOSYLATION	CDG TYPE I
TYPE I CONGENITAL DISORDERS OF GLYCOSYLATION	CDG TYPE I
TYPE II CONGENITAL DISORDERS OF GLYCOSYLATION	CDG TYPE I
CARBOHYDRATE DEFICIENT GLYCOPROTEIN SYNDROME I A	CDG TYPE IA
CARBOHYDRATE DEFICIENT GLYCOPROTEIN SYNDROME SUBTYPE IA	CDG TYPE IA
CARBOHYDRATE DEFICIENT GLYCOPROTEIN SYNDROME TYPE IA	CDG TYPE IA
CARBOHYDRATE-DEFICIENT GLYCOCONJUGATE SYNDROME TYPE IA	CDG TYPE IA
CARBOHYDRATE-DEFICIENT GLYCOPROTEIN ( CDG ) SYNDROME TYPE IA	CDG TYPE IA
CARBOHYDRATE-DEFICIENT GLYCOPROTEIN SYNDROME IA	CDG TYPE IA
CARBOHYDRATE-DEFICIENT GLYCOPROTEIN SYNDROME TYPE 1A	CDG TYPE IA
CARBOHYDRATE-DEFICIENT GLYCOPROTEIN SYNDROME TYPE IA	CDG TYPE IA
CDG IA	CDG TYPE IA
CDG SYNDROME IA	CDG TYPE IA
CDG SYNDROME TYPE IA	CDG TYPE IA
CDG TYPE 1A	CDG TYPE IA
CDG1A	CDG TYPE IA
CDG-1A	CDG TYPE IA
CDGIA	CDG TYPE IA
CDG-IA	CDG TYPE IA
CDGIA SYNDROME	CDG TYPE IA
CDGS I A	CDG TYPE IA
CDGS IA	CDG TYPE IA
CDGS TYPE 1A	CDG TYPE IA
CDGS TYPE IA	CDG TYPE IA
CDGS1A	CDG TYPE IA
CONGENITAL DISORDER OF GLYCOSYLATION ( CDG ) TYPE IA	CDG TYPE IA
"CONGENITAL DISORDER OF GLYCOSYLATION , TYPE IA"	CDG TYPE IA
CONGENITAL DISORDER OF GLYCOSYLATION PMM2-CDG	CDG TYPE IA
CONGENITAL DISORDER OF GLYCOSYLATION TYPE 1A	CDG TYPE IA
CONGENITAL DISORDER OF GLYCOSYLATION TYPE IA	CDG TYPE IA
CONGENITAL DISORDER OF GLYCOSYLATION TYPE-IA	CDG TYPE IA
CONGENITAL DISORDER OF GLYCOSYLATION-IA	CDG TYPE IA
CONGENITAL DISORDERS OF GLYCOSYLATION TYPE IA	CDG TYPE IA
PMM2-CDG	CDG TYPE IA
PMM-DEFICIENT CDGS TYPE 1	CDG TYPE IA
TYPE 1A CDG	CDG TYPE IA
TYPE IA CDG	CDG TYPE IA
CARBOHYDRATE DEFICIENT GLYCOPROTEIN SYNDROME SUBTYPE IB	CDG TYPE IB
CARBOHYDRATE DEFICIENT GLYCOPROTEIN SYNDROME TYPE 1B	CDG TYPE IB
CARBOHYDRATE-DEFICIENT GLYCOPROTEIN SYNDROME 1B	CDG TYPE IB
CARBOHYDRATE-DEFICIENT GLYCOPROTEIN SYNDROME TYPE 1B	CDG TYPE IB
CARBOHYDRATE-DEFICIENT GLYCOPROTEIN SYNDROME TYPE IB	CDG TYPE IB
CDG IB	CDG TYPE IB
CDG SYNDROME TYPE 1B	CDG TYPE IB
CDG TYPE IB	CDG TYPE IB
CDG-IB	CDG TYPE IB
CDGS 1B	CDG TYPE IB
CDGS TYPE IB	CDG TYPE IB
CDGS1B	CDG TYPE IB
CONGENITAL DISORDER OF GLYCOSYLATION IA	CDG TYPE IB
CONGENITAL DISORDER OF GLYCOSYLATION IB	CDG TYPE IB
CONGENITAL DISORDER OF GLYCOSYLATION TYPE 1B	CDG TYPE IB
CONGENITAL DISORDER OF GLYCOSYLATION TYPE IB	CDG TYPE IB
MPI-CDG	CDG TYPE IB
CDG IC	CDG TYPE IC
CDG-IC	CDG TYPE IC
CDGS TYPE IC	CDG TYPE IC
CONGENITAL DISORDER OF GLYCOSYLATION TYPE IC	CDG TYPE IC
CONGENITAL DISORDER OF GLYCOSYLATION-IC	CDG TYPE IC
CDG ID	CDG TYPE ID
CDG-ID	CDG TYPE ID
CONGENITAL DISORDER OF GLYCOSYLATION TYPE ID	CDG TYPE ID
CONGENITAL DISORDER OF GLYCOSYLATION-ID	CDG TYPE ID
CDG-IE	CDG TYPE IE
CONGENITAL DISORDER OF GLYCOSYLATION IE	CDG TYPE IE
CDG IG	CDG TYPE IG
CDG-IG	CDG TYPE IG
CDG IH	CDG TYPE IH
CDG-IH	CDG TYPE IH
CARBOHYDRATE DEFICIENT SYNDROME TYPE II	CDG TYPE II
CDG GROUP II	CDG TYPE II
CDG II	CDG TYPE II
CDG TYPE 2	CDG TYPE II
CDG-II	CDG TYPE II
CDGII DISORDERS	CDG TYPE II
CDGS TYPE II	CDG TYPE II
CONGENITAL DISORDER OF GLYCOSYLATION II	CDG TYPE II
CONGENITAL DISORDER OF GLYCOSYLATION TYPE II	CDG TYPE II
TYPE II CDGS	CDG TYPE II
CDG-IIA	CDG TYPE IIA
CONGENITAL DISORDER OF GLYCOSYLATION TYPE IIA	CDG TYPE IIA
CDG-IIB	CDG TYPE IIB
CONGENITAL DISORDER OF GLYCOSYLATION TYPE IIB	CDG TYPE IIB
CDG-IIC	CDG TYPE IIC
CGD IIC	CDG TYPE IIC
CONGENITAL DISORDER OF GLYCOSYLATION TYPE IIC	CDG TYPE IIC
CDG-IID	CDG TYPE IID
CONGENITAL DISORDER OF GLYCOSYLATION IID	CDG TYPE IID
CONGENITAL DISORDER OF GLYCOSYLATION TYPE IID	CDG TYPE IID
CDG-IIE	CDG TYPE IIE
CARBOHYDRATE DEFICIENT GLYCOPROTEIN SYNDROME TYPE IV	CDG TYPE IV
CARBOHYDRATE DEFICIENT GLYCOPROTEIN SYNDROME SUBTYPE IX	CDG TYPE IX
CARBOHYDRATE DEFICIENT GLYCOPROTEIN SYNDROME TYPE IX	CDG TYPE IX
CDG I	CDG TYPE IX
CDG IX	CDG TYPE IX
CDG-IX	CDG TYPE IX
CONGENITAL DISORDER OF GLYCOSYLATION TYPE IX	CDG TYPE IX
CARBOHYDRATE-DEFICIENT GLYCOPROTEIN SYNDROME TYPE V	CDG TYPE V
CENTRAL NERVOUS SYSTEM DYSFUNCTION	CENTRAL NERVOUS SYSTEM ABNORMALITIES
CEREBELLAR AND BRAINSTEM ATROPHY	CEREBELLAR AND BRAIN STEM ATROPHY
CEREBELLAR ATROPHIES	CEREBELLAR ATROPHY
COAGULATION ABNORMITIES	COAGULATION ABNORMALITIES
COAGULATION DISTURBANCE	COAGULATION ABNORMALITIES
COAGULATION DISTURBANCES	COAGULATION ABNORMALITIES
COAGULATION DISORDERS	COAGULATION DISORDER
COAGULOPATHIES	COAGULATION DISORDER
COAGULOPATHY	COAGULATION DISORDER
BORDERLINE COGNITIVE ABILITIES	COGNITIVE IMPAIRMENT
BORDERLINE COGNITIVE DYSFUNCTION	COGNITIVE IMPAIRMENT
COGNITIVE DEFICITS	COGNITIVE IMPAIRMENT
INTELLECTUAL DISABILITIES	COGNITIVE IMPAIRMENT
INTELLECTUAL DISABILITY	COGNITIVE IMPAIRMENT
INTELLECTUAL IMPAIRMENT	COGNITIVE IMPAIRMENT
MENTAL RETARDATION	COGNITIVE IMPAIRMENT
MILD DEMENTIA	COGNITIVE IMPAIRMENT
MODERATE COGNITIVE IMPAIRMENT	COGNITIVE IMPAIRMENT
CONGENITAL ALACRIMIA	CONGENITAL ALACRIMA
CONGENITAL HEREDITARY AUTOSOMAL RECESSIVE ALACRIMA	CONGENITAL ALACRIMA
CONGENITAL LACK OF TEARS	CONGENITAL ALACRIMA
HEREDITARY CONGENITAL ALACRIMA	CONGENITAL ALACRIMA
CARBOHYDRATE DEFICIENT GLYCOPROTEIN ( CDG ) SYNDROME	CONGENITAL DISORDER OF GLYCOSYLATION
CARBOHYDRATE DEFICIENT GLYCOPROTEIN SYNDROME	CONGENITAL DISORDER OF GLYCOSYLATION
CARBOHYDRATE DEFICIENT GLYCOPROTEIN SYNDROMES	CONGENITAL DISORDER OF GLYCOSYLATION
CARBOHYDRATE-DEFICIENT BLOOD GLYCOPROTEIN SYNDROME	CONGENITAL DISORDER OF GLYCOSYLATION
CARBOHYDRATE-DEFICIENT GLYCOPROTEIN ( CDG ) SYNDROME	CONGENITAL DISORDER OF GLYCOSYLATION
CARBOHYDRATE-DEFICIENT GLYCOPROTEIN ( CDG ) SYNDROMES	CONGENITAL DISORDER OF GLYCOSYLATION
CARBOHYDRATE-DEFICIENT GLYCOPROTEIN PROTEIN SYNDROME	CONGENITAL DISORDER OF GLYCOSYLATION
CARBOHYDRATE-DEFICIENT GLYCOPROTEIN SYNDROME	CONGENITAL DISORDER OF GLYCOSYLATION
CARBOHYDRATE-DEFICIENT GLYCOPROTEIN SYNDROMES	CONGENITAL DISORDER OF GLYCOSYLATION
CARBOHYDRATE-DEFICIENT GLYCOPROTEIN TYPE I SYNDROME	CONGENITAL DISORDER OF GLYCOSYLATION
CARBOHYDRATE-DEFICIENT-GLYCOPROTEIN SYNDROME	CONGENITAL DISORDER OF GLYCOSYLATION
CARBOHYDRATE-DEFICIENT-GLYCOPROTEIN SYNDROMES	CONGENITAL DISORDER OF GLYCOSYLATION
CDG	CONGENITAL DISORDER OF GLYCOSYLATION
CDG SYNDROME	CONGENITAL DISORDER OF GLYCOSYLATION
CDG SYNDROMES	CONGENITAL DISORDER OF GLYCOSYLATION
CDGS	CONGENITAL DISORDER OF GLYCOSYLATION
CDGS SYNDROME	CONGENITAL DISORDER OF GLYCOSYLATION
CONGENITAL DISORDERS OF GLYCOSYLATION	CONGENITAL DISORDER OF GLYCOSYLATION
CONGENITAL GLYCOSYLATION DISORDER	CONGENITAL DISORDER OF GLYCOSYLATION
CONGENITAL GLYCOSYLATION DISORDERS	CONGENITAL DISORDER OF GLYCOSYLATION
CONGENITAL MYASTHENIC SYNDROMES	CONGENITAL MYASTHENIC SYNDROME
CRANIOFACIAL DEFECTS	CRANIOFACIAL ABNORMALITIES
CRANIOFACIAL DYSMORPHIC FEATURES	CRANIOFACIAL ABNORMALITIES
CUTIS LAXA	CUTIS LAXA
CUTIS LAXA SYNDROME	CUTIS LAXA
CUTIS LAXA SYNDROMES	CUTIS LAXA
CUTIS LAXA-RELATED	CUTIS LAXA-RELATED DISEASES
DERMATOLOGICAL MANIFESTATIONS	DERMATOLOGICAL ABNORMALITIES
DEVELOPMENTAL AND PSYCHOMOTOR ABNORMALITIES	DEVELOPMENTAL ABNORMALITIES
DEVELOPMENTAL RETARDATION	DEVELOPMENTAL ABNORMALITIES
DELAYED DEVELOPMENT	DEVELOPMENTAL DELAY
DELAYED DEVELOPMENTAL MILESTONES	DEVELOPMENTAL DELAY
DELAYED PUBERTY	DEVELOPMENTAL DELAY
DEVELOPMENT DELAY	DEVELOPMENTAL DELAY
DEVELOPMENTAL DELAYS	DEVELOPMENTAL DELAY
GLOBAL DEVELOPMENTAL DELAY	DEVELOPMENTAL DELAY
MILD DEVELOPMENTAL DELAY	DEVELOPMENTAL DELAY
DIARRHEAL DISEASES	DIARRHEA
DIARRHOEA	DIARRHEA
DIET	DIETARY TREATMENT
DIETARY MODIFICATION	DIETARY TREATMENT
DIETARY THERAPIES	DIETARY TREATMENT
DISIALOTRANSFERRIN	DISIALO-TRANSFERRIN
CONGENITAL DISORDERS OF N-LINKED GLYCOSYLATION	DISORDERS OF N-GLYCOSYLATION
DISORDERS OF PROTEIN N-GLYCOSYLATION	DISORDERS OF N-GLYCOSYLATION
N-GLYCOSYLATION DEFECT	DISORDERS OF N-GLYCOSYLATION
N-LINKED CDG DISORDERS	DISORDERS OF N-GLYCOSYLATION
N-LINKED GLYCOSYLATION DEFICIENCY	DISORDERS OF N-GLYCOSYLATION
DISORDERS OF PROTEIN O-GLYCOSYLATION	DISORDERS OF O-GLYCOSYLATION
DOLICHOL PHOSPHATE-MANNOSE SYNTHASE	DOLICHOL PHOSPHATE MANNOSE SYNTHASE
DOLICHOL-PHOSPHATE-MANNOSE SYNTHASE	DOLICHOL PHOSPHATE MANNOSE SYNTHASE
DRY EYE	DRY EYES
ENDO- BETA-N-ACETYLGUCOSAMINIDASES	ENGASE
ENDO-BETA-N-ACETYLGLUCOSAMINIDASE	ENGASE
ENDO-BETA-N-ACETYLGLUCOSAMINIDASES	ENGASE
ENDO-N-ACETYL-BETA-D-GLUCOSAMINIDASE	ENGASE
ENDO-N-ACETYL-BETA-D-GLUCOSAMINIDASES	ENGASE
ENGASE1P	ENGASE
ENGASES	ENGASE
ENDO-A	ENGASE A
ENDO-BETA-N-ACETYLGLUCOSAMINIDASE A	ENGASE A
ENDO-BETA-N-ACETYLGUCOSAMINIDASE A	ENGASE A
OESOPHAGEAL ACHALASIA	ESOPHAGEAL ACHALASIA
OESOPHAGEAL DILATATION	ESOPHAGEAL DILATION
ESOPHAGEAL DYSMOTILITY	ESOPHAGEAL DYSFUNCTION
OESOPHAGEAL DYSMOTILITY	ESOPHAGEAL DYSFUNCTION
FAILED TO THRIVE	FAILURE TO THRIVE
FEEDING DIFFICULTIES	FEEDING PROBLEMS
G ( OPITZ FRIAS ) SYNDROME	G ( OPITZ-FRIAS ) SYNDROME
G SYNDROME	G ( OPITZ-FRIAS ) SYNDROME
GAIT DISTURBANCE	GAIT ABNORMALITIES
GALACTOSE SUPPLEMENTATION	GALACTOSE
GALACTOSE THERAPY	GALACTOSE
GALACTOSAEMIA	GALACTOSEMIA
GASTRO-OESOPHAGEAL REFLUX	GASTROESOPHAGEAL REFLUX
GER	GASTROESOPHAGEAL REFLUX
GASTROINTESTINAL BLEEDING	GASTROINTESTINAL PROBLEMS
GASTROINTESTINAL SYMPTOMS	GASTROINTESTINAL PROBLEMS
GENETIC DEFECTS	GENETIC DISORDERS
GENETIC DISEASES	GENETIC DISORDERS
GENETIC DISORDERS	GENETIC DISORDERS
GENITALIA MALFORMATIONS	GENITAL ABNORMALITIES
GLUCOCORTICOID DEFICIENCY	GLUCOCORTICOID INSUFFICIENCY
GLUCOCORTICOID THERAPY	GLUCOCORTICOID REPLACEMENT THERAPY
GLYCOSYLTRANSFERASES	GLUCOSYLTRANSFERASE I
GLYCOSYLATION DEFECTS	GLYCOSYLATION ABNORMALITIES
GLYCOSYLATION DISEASES	GLYCOSYLATION DISORDERS
GLYCOSYLATION DISORDER	GLYCOSYLATION DISORDERS
HYPERPIGMENTED	HYPERPIGMENTATION
HYPER-REFLEXIA	HYPERREFLEXIA
HYPOGLYCAEMIA	HYPOGLYCEMIA
 HYPOLACRIMA	HYPOLACRIMA
DECREASED SECRETION OF TEAR	HYPOLACRIMA
DEFICIENT TEAR PRODUCTION	HYPOLACRIMA
MUSCLE HYPOTONIA	HYPOTONIA
MUSCLE WEAKNESS	HYPOTONIA
MUSCULAR HYPOTONIA	HYPOTONIA
WEAKNESS IN ALL LIMBS	HYPOTONIA
HIF-1	HYPOXIA-INDUCIBLE FACTOR 1
AUTOSOMAL RECESSIVE HEREDITARY METABOLIC DISORDER	INHERITED METABOLIC DISORDERS
AUTOSOMAL RECESSIVE INHERITED METABOLIC DISEASES	INHERITED METABOLIC DISORDERS
AUTOSOMAL RECESSIVE METABOLIC DISEASE	INHERITED METABOLIC DISORDERS
INBORN ERRORS IN METABOLISM	INHERITED METABOLIC DISORDERS
INBORN ERRORS OF METABOLISM	INHERITED METABOLIC DISORDERS
IL-1 BETA	INTERLEUKIN-1 BETA
LEUCOCYTE ADHESION DEFICIENCY TYPE II	LEUKOCYTE ADHESION DEFICIENCY TYPE II
LIVER DISEASE	LIVER DYSFUNCTION
LIVER DISEASES	LIVER DYSFUNCTION
LIVER FAILURE	LIVER DYSFUNCTION
LIVER IMPAIRMENT	LIVER DYSFUNCTION
LYSOSOMAL DISEASES	LYSOSOMAL DISEASE
LYSOSOMAL DISORDERS	LYSOSOMAL DISEASE
LYSOSOMAL STORAGE DISEASES	LYSOSOMAL STORAGE DISEASE
LYSOSOMAL STORAGE DISORDERS	LYSOSOMAL STORAGE DISEASE
MANNOSE SUPPLEMENTATION	MANNOSE
MANNOSYLTRANSFERASES	MANNOSYLTRANSFERASE
ACTH RECEPTOR	MELANOCORTIN-2 RECEPTOR
MC2R	MELANOCORTIN-2 RECEPTOR
MELANOCORTIN 2 RECEPTOR ACCESSORY PROTEIN	MELANOCORTIN-2 RECEPTOR ACCESSORY PROTEIN
METABOLIC DISEASES	METABOLIC DISEASE
METABOLIC DISORDER	METABOLIC DISEASE
METABOLIC DISORDERS	METABOLIC DISEASE
MITOCHONDRIAL DISEASES	MITOCHONDRIAL DISEASE
MITOCHONDRIAL DISORDERS	MITOCHONDRIAL DISEASE
MULTISYSTEM ANOMALIES	MULTISYSTEM DISORDER
MULTISYSTEM NEUROLOGICAL DISEASE	MULTISYSTEM DISORDER
MULTISYSTEMIC DISEASE	MULTISYSTEM DISORDER
BETA-N-ACETYLHEXOSAMINIDASE	NAGASE
NAGASES	NAGASE
NEONATAL HYPOGLYCAEMIA	NEONATAL HYPOGLYCEMIA
NEUROLOGIC ANOMALIES	NEUROLOGIC ABNORMALITIES
NEUROLOGIC PROBLEMS	NEUROLOGIC ABNORMALITIES
NEUROLOGICAL SYMPTOMS	NEUROLOGIC ABNORMALITIES
NEUROLOGICAL ABNORMALITIES	NEUROLOGICAL IMPAIRMENT
NEUROLOGICAL DEFICITS	NEUROLOGICAL IMPAIRMENT
NEUROLOGICAL DISORDER	NEUROLOGICAL IMPAIRMENT
NEUROLOGICAL DISORDERS	NEUROLOGICAL IMPAIRMENT
NEUROLOGICAL DISTURBANCES	NEUROLOGICAL IMPAIRMENT
NEUROLOGICAL DYSFUNCTION	NEUROLOGICAL IMPAIRMENT
NEUROLOGICAL DYSFUNCTIONS	NEUROLOGICAL IMPAIRMENT
NEUROLOGICAL IMPAIRMENTS	NEUROLOGICAL IMPAIRMENT
NEUROLOGICALLY IMPAIRED	NEUROLOGICAL IMPAIRMENT
N GLYCANASE	NGLY1
N-GLYCANASE	NGLY1
PEPTIDE-N ( 4 ) - ( N-ACETYL-BETA-D-GLUCOSAMINYL ) ASPARAGINE AMIDASE	NGLY1
PEPTIDE-N4- ( N-ACETYL- [ BETA ] -D-GLUCOSAMINYL ) ASPARAGINE AMIDASE	NGLY1
PEPTIDE-N4- ( N-ACETYL-BETA-D-GLUCOSAMINYL ) ASPARAGINE AMIDASE	NGLY1
PEPTIDE-N4- ( N-ACETYL-BETA-D-GLUCOSAMINYL ) ASPARAGINE AMIDASES	NGLY1
PEPTIDE-N4- ( N-ACETYL-GLUCOSAMINYL ) ASPARAGINE AMIDASE	NGLY1
PEPTIDE-N4-(N-ACETYL-BETA-GLUCOSAMINYL)ASPARAGINE AMIDASE	NGLY1
PNGASE	NGLY1
PNGASES	NGLY1
CONGENITAL DISORDER OF N-GLYCOSYLATION	NGLY1 DEFICIENCY
DEFICIENCY OF N-GLYCANASE 1	NGLY1 DEFICIENCY
NGLY1-DEFICIENCY	NGLY1 DEFICIENCY
NGR1	NOGO RECEPTOR 2
NGR2	NOGO RECEPTOR 2
NR1	NOGO RECEPTOR 2
OLIGOSACCHARYLTRANSFERASE	OLIGOSACCHARYL TRANSFERASE
OST	OLIGOSACCHARYL TRANSFERASE
PARKINSON DISEASE	PARKINSONS DISEASE
PARKINSON 'S	PARKINSONS DISEASE
PARKINSON 'S DISEASE	PARKINSONS DISEASE
PARKINSONION DISEASE	PARKINSONS DISEASE
PARKINSON'S	PARKINSONS DISEASE
PARKINSON'S DISEASE	PARKINSONS DISEASE
PD	PARKINSONS DISEASE
PGM1	PHOSPHOGLUCOMUTASE 1
PHOSPHOGLUCOMUTASE-1	PHOSPHOGLUCOMUTASE 1
PHOSPHOMANNOMUTASES	PHOSPHOMANNOMUTASE
PMM	PHOSPHOMANNOMUTASE
PMMS	PHOSPHOMANNOMUTASE
PMM1	PHOSPHOMANNOMUTASE 1
PHOSPHOMANNOMUTASE-2	PHOSPHOMANNOMUTASE 2
PMM2	PHOSPHOMANNOMUTASE 2
MPI	PHOSPHOMANNOSE ISOMERASE
PMI	PHOSPHOMANNOSE ISOMERASE
PMI-DEFICIENT	PMI DEFICIENCY
PMM1-DEFICIENCY	PMM1-DEFICIENCY
PMM1-DEFICIENT	PMM1-DEFICIENCY
PHOSPHOMANNOMUTASE 2 DEFICIENCY	PMM2 DEFICIENCY
PHOSPHOMANNOMUTASE 2-DEFICIENCY	PMM2 DEFICIENCY
PHOSPHOMANNOMUTASE-2 DEFICIENCY	PMM2 DEFICIENCY
PHOSPHOMANNOMUTASE-2-DEFICIENCY	PMM2 DEFICIENCY
PMM2 DEFICIENCY	PMM2-DEFICIENCY
PMM DEFICIENCY	PMM-DEFICIENCY
PMM-DEFICIENT	PMM-DEFICIENCY
APNGASE	PNGASE A
CPNGASE	PNGASE C
PRELYSOSOMAL '' DISORDERS	PRELYSOSOMAL DISORDERS
PROGRESSIVE NEURODEGENERATION	PROGRESSIVE NEUROLOGICAL IMPAIRMENT
PROGRESSIVE NEURODEGENERATIVE DISEASE	PROGRESSIVE NEUROLOGICAL IMPAIRMENT
PROGRESSIVE NEUROLOGIC SYMPTOMS	PROGRESSIVE NEUROLOGICAL IMPAIRMENT
PROGRESSIVE NEUROLOGICAL DEGENERATION	PROGRESSIVE NEUROLOGICAL IMPAIRMENT
PROGRESSIVE NEUROLOGICAL MANIFESTATIONS	PROGRESSIVE NEUROLOGICAL IMPAIRMENT
PROGRESSIVE NEUROLOGICAL SYNDROME	PROGRESSIVE NEUROLOGICAL IMPAIRMENT
PROGRESSIVE NEURONAL DISEASE	PROGRESSIVE NEUROLOGICAL IMPAIRMENT
VISUAL DEMISE	PROGRESSIVE VISUAL IMPAIRMENT
VISUAL LOSS	PROGRESSIVE VISUAL IMPAIRMENT
PROTEIN LOSING ENTEROPATHY	PROTEIN-LOSING ENTEROPATHY
PROTEIN-LOSING ENTEROPATHIES	PROTEIN-LOSING ENTEROPATHY
MILD PSYCHOMOTOR RETARDATION	PSYCHOMOTOR IMPAIRMENT
PSYCHOMOTOR DELAY	PSYCHOMOTOR IMPAIRMENT
PSYCHOMOTOR RETARDATION	PSYCHOMOTOR IMPAIRMENT
SEVERE PSYCHOMOTOR RETARDATION	PSYCHOMOTOR IMPAIRMENT
RECURRENT BACTERIAL INFECTIONS	RECURRENT INFECTIONS
RECURRENT INFECTION	RECURRENT INFECTIONS
CYCLIC VOMITING	RECURRENT VOMITING
VOMITING EPISODES	RECURRENT VOMITING
REDUCED ROD RESPONSE	REDUCED ROD RESPONSES
SENSORY DISTURBANCE	SENSORY IMPAIRMENT
SENSORY DISTURBANCES	SENSORY IMPAIRMENT
SHORT-CHAIN 3-HYDROXYACYL-COA DEHYDROGENASE	SHORT-CHAIN L-3-HYDROXYACYL-COA DEHYDROGENASE
SJOGREN 'S SYNDROME	SJOGREN SYNDROME
SPINAL DEFORMITY	SPINAL DEFORMITIES
STROKE-LIKE EPISODE	STROKE-LIKE EPISODES
STROKELIKE EPISODES	STROKE-LIKE EPISODES
STROKE-LIKE EVENTS	STROKE-LIKE EPISODES
SUR1	SUR-1
TGF-BETA	TGF-BETA 1
THROMBOSES	THROMBOSIS
THYROID DYSFUNCTION	THYROID ABNORMALITIES
TF	TRANSFERRIN
TF D	TRANSFERRIN D
TRIPLE A SYNDROME-LIKE DISEASE	TRIPLE-A-LIKE SYNDROME
V-ATPASES	V-ATPASE
VENOUS THROMBOSES	VENOUS THROMBOSIS
VOMITING CRISIS	VOMITING
